可达鸭
⠀⠀⠀⠀⠀⠀⠀⠀⠀⠀⠀⠀⠀⠀⠀⠀⠀⠀⠀⠀⠀⠀⢀⣴⣶⣦⡀⠀⠀⠀⠀⣶⣷⣶⡆⠀⠀⠀⠀⠀⠀⠀⠀⠀⠀⠀⠀⠀⠀⠀⠀⠀⠀⠀⠀⠀⠀⠀⠀⠀⠀⠀⠀⠀⠀
⠀⠀⠀⠀⠀⠀⠀⠀⠀⠀⠀⠀⠀⠀⠀⠀⠀⠀⠀⠀⠀⠰⣿⣿⣿⣿⣿⣄⠀⠀⠀⣿⣿⣿⡇⠀⠀⠀⠀⠀⠀⠀⠀⠀⠀⠀⠀⠀⠀⠀⠀⠀⠀⠀⠀⠀⠀⠀⠀⠀⠀⠀⠀⠀⠀
⠀⠀⠀⠀⠀⠀⠀⠀⠀⠀⠀⠀⠀⠀⠀⠀⠀⠀⠀⠀⠀⠀⠈⢿⣿⣿⣿⣿⣧⡀⠀⢻⣿⣿⡇⠀⠀⠀⠀⠀⠀⠀⠀⠀⠀⠀⠀⠀⠀⠀⠀⠀⠀⠀⠀⠀⠀⠀⠀⠀⠀⠀⠀⠀⠀
⠀⠀⠀⠀⠀⠀⠀⠀⠀⠀⠀⠀⠀⠀⠀⠀⠀⠀⠀⠀⠀⠀⠀⠀⠙⢿⣿⣿⣿⣷⡀⢸⣿⣿⡇⠀⠀⠀⠀⠀⠀⠀⠀⠀⠀⠀⠀⠀⠀⠀⠀⠀⠀⠀⠀⠀⠀⠀⠀⠀⠀⠀⠀⠀⠀
⠀⠀⠀⠀⠀⠀⠀⠀⠀⠀⠀⠀⠀⠀⠀⠀⠀⠀⠀⠀⠀⣤⣤⣀⡀⠈⠻⣿⣿⣿⣷⣸⣿⣿⡇⠀⠀⠀⠀⠀⠀⠀⠀⠀⠀⠀⠀⠀⠀⠀⠀⠀⠀⠀⠀⠀⠀⠀⠀⠀⠀⠀⠀⠀⠀
⠀⠀⠀⠀⠀⠀⠀⠀⠀⠀⠀⠀⠀⠀⠀⠀⠀⠀⠀⠀⢰⣿⣿⣿⣿⣷⣶⣌⣻⣿⣿⣷⣿⣿⠀⠀⠀⠀⠀⠀⠀⠀⠀⠀⠀⠀⠀⠀⠀⠀⠀⠀⠀⠀⠀⠀⠀⠀⠀⠀⠀⠀⠀⠀⠀
⠀⠀⠀⠀⠀⠀⠀⠀⠀⠀⠀⠀⠀⠀⠀⠀⠀⠀⠀⠀⠘⠿⢿⣿⣿⣿⣿⣿⣿⣿⣿⡿⠿⠿⠶⠦⠶⠴⣦⣤⣤⣀⣀⡀⠀⠀⠀⠀⠀⠀⠀⠀⠀⠀⠀⠀⠀⠀⠀⠀⠀⠀⠀⠀⠀
⠀⠀⠀⠀⠀⠀⠀⠀⠀⠀⠀⠀⠀⠀⠀⠀⠀⠀⠀⠀⠀⣀⣤⣴⠾⠛⠋⠉⠉⠀⠀⠀⠀⠀⠀⠀⠀⠀⠀⠀⠀⠉⠉⠛⠛⠶⣦⣄⡀⠀⠀⠀⠀⣠⣤⡀⠀⠀⠀⠀⠀⠀⠀⠀⠀
⠀⠀⠀⠀⠀⠀⠀⠀⠀⠀⠀⠀⠀⠀⠀⠀⠀⢀⣠⣶⠟⠋⠁⠀⠀⠀⠀⠀⠀⠀⠀⠀⠀⠀⠀⠀⠀⠀⠀⠀⠀⠀⠀⠀⠀⠀⠀⠉⠛⠷⣿⣛⠒⠏⠈⢷⡄⠀⠀⠀⠀⠀⠀⠀⠀
⠀⠀⠀⠀⠀⠀⠀⠀⠀⠀⠀⠀⠀⠀⠀⢀⣴⠟⠋⠀⠀⠀⠀⠀⠀⠀⠀⠀⠀⠀⠀⠀⠀⠀⠀⠀⠀⠀⠀⠀⠀⠀⠀⠀⠀⠀⠀⠀⠀⠀⠈⠙⢷⣄⠀⠈⢿⡄⠀⠀⠀⠀⠀⠀⠀
⠀⠀⠀⠀⠀⠀⠀⠀⠀⠀⢀⠀⠀⢀⣴⠟⠁⠀⠀⠀⠀⠀⠀⠀⠀⠀⠀⠀⠀⠀⠀⠀⠀⠀⠀⠀⠀⠀⠀⠀⠀⠀⠀⠀⠀⠀⠀⠀⠀⠀⠀⠀⠀⠙⢷⣄⠈⠻⣦⡀⠀⠀⠀⠀⠀
⠀⠀⠀⠀⠀⠀⠀⠀⠀⣰⡟⢳⡴⠟⢻⣦⣄⠀⠀⠀⠀⢀⣀⣤⣤⠶⠶⠶⢶⣤⣄⡀⠀⠀⠀⠀⠀⠀⠀⠀⠀⢀⣠⣤⠶⠶⠶⠶⠦⣤⣀⠀⠀⠀⠈⢻⣆⠀⠈⠿⣆⠀⠀⠀⠀
⠀⠀⠀⠀⠀⠀⠀⠀⠀⣿⠀⠀⠀⠀⠈⠉⣿⠂⠀⣠⡶⠟⠋⠁⠀⠀⠀⠀⠀⠀⠉⠙⢶⡄⠀⠀⠀⠀⠀⠀⣰⠟⠉⠀⠀⠀⠀⠀⠀⠀⠉⠛⢦⡀⠀⠀⢻⡆⠀⠀⠙⣷⡄⠀⠀
⠀⠀⠀⠀⠀⠀⠀⠀⢰⡿⠀⠀⠀⠀⠀⢠⡿⠀⣴⠟⠀⠀⠀⠀⠀⠀⣀⡀⠀⠀⠀⠀⠀⣿⡀⠀⠀⠀⠀⢰⡟⠀⠀⠀⢠⣶⡄⠀⠀⠀⠀⠀⠈⢻⡄⠀⠘⣿⠀⠀⠀⠘⣿⡄⠀
⠀⠀⠀⠀⠀⠀⠀⢠⡿⠁⠀⠀⠀⠀⠀⢸⡇⠀⣿⠀⠀⠀⠀⠀⠀⠀⠛⠋⠀⠀⠀⠀⠀⣿⠀⠀⠀⠀⠀⠀⢻⣄⠀⠀⠀⠉⠀⠀⠀⠀⠀⠀⠀⣸⠇⠀⠀⣿⠀⠀⠀⠀⠘⣿⡀
⠀⠀⠀⠀⠀⠀⢠⡿⠁⠀⠀⠀⠀⠀⠀⠘⣷⠀⠻⣦⠀⠀⠀⠀⠀⠀⠀⠀⠀⠀⠀⣠⡾⠁⠀⠀⣀⣤⣄⣀⠀⠙⠷⣄⣀⠀⠀⠀⠀⠀⢀⣠⡼⠋⠀⠀⠀⣿⠀⠀⠀⠀⠀⢻⡇
⠀⠀⠀⠀⠀⢠⣿⠁⠀⠀⠀⠀⠀⠀⠀⠀⣿⠀⠀⠉⠻⠶⣤⣀⣀⣀⣀⣤⡤⠶⠛⠁⠀⢀⣴⡾⠛⠉⠈⠙⠻⢦⣄⠈⠉⠙⠛⠛⠛⠛⠋⠁⠀⠀⠀⠀⢸⡿⠀⠀⠀⠀⠀⢸⣿
⠀⠀⠀⠀⠀⣾⠃⠀⠀⠀⠀⠀⠀⠀⠀⠀⣿⠀⠀⠀⠀⠀⠀⠈⠉⠉⠁⠀⠀⠀⢀⣠⠾⠋⣁⡀⠀⠀⠀⠀⢀⣀⠉⠻⠶⠶⠤⠤⢤⣤⣄⠀⠀⠀⠀⣠⣿⠁⠀⠀⠀⠀⠀⢸⣿
⠀⠀⠀⠀⢰⡿⠀⠀⠀⠀⠀⠀⠀⠀⠀⠀⢹⡆⠀⠀⠀⠀⣀⣀⣤⣤⣤⠶⠶⠞⠛⠉⠀⠀⠉⢿⡆⠀⠀⠀⠾⠁⠀⠀⠀⠀⠀⠀⠀⠀⢻⡆⠀⠀⣰⡿⠁⠀⠀⠀⠀⠀⠀⢸⡏
⠀⠀⠀⠀⣿⡇⠀⠀⠀⠀⠀⠀⠀⠀⠀⠀⢸⣇⠀⠀⠀⣾⠛⠉⠀⠀⠀⠀⠀⠀⠀⠀⠀⠀⠀⠀⠀⠀⠀⠀⠀⠀⠀⠀⠀⠀⠀⠀⠀⠀⢸⣇⣠⡾⠋⠀⠀⠀⠀⠀⠀⠀⠀⣾⡃
⠀⠀⠀⠀⣿⠀⠀⠀⠀⠀⠀⠀⠀⠀⠀⠀⠸⣿⣄⡀⠀⢹⡆⠀⠀⠀⠀⠀⠀⠀⠀⠀⠀⠀⠀⠀⠀⠀⠀⠀⠀⠀⠀⠀⠀⠀⠀⠀⠀⠀⠀⠙⠻⣶⣄⠀⠀⠀⠀⠀⠀⠀⢰⡿⠀
⠀⠀⠀⠀⣿⠀⠀⠀⠀⠀⠀⠀⠀⠀⠀⠀⠀⣿⡍⠻⠷⣼⡇⠀⠀⠀⠀⠀⠀⠀⠀⠀⠀⠀⠀⠀⠀⠀⠀⠀⠀⠀⠀⠀⠀⠀⠀⠀⠀⠀⠀⠀⠀⠀⠙⣷⡀⠀⠀⠀⠀⢠⣿⠁⠀
⠀⠀⠀⠀⣿⠀⠀⠀⠀⠀⠀⠀⠀⠀⠀⠀⠀⢹⡇⠀⠀⣿⠂⠀⠀⠀⠀⠀⠀⠀⠀⠀⠀⠀⠀⠀⠀⠀⠀⠀⠀⠀⠀⠀⠀⠀⠀⠀⠀⠀⠀⠀⠀⠀⠀⠈⣿⡀⠀⠀⣠⡿⠁⠀⠀
⠀⠀⠀⠀⣿⠀⠀⠀⠀⠀⠀⠀⠀⠀⠀⠀⠀⢸⡇⠀⢰⣿⠀⠀⠀⠀⠀⠀⠀⠀⠀⠀⠀⠀⠀⠀⠀⠀⠀⠀⠀⠀⠀⠀⠀⠀⠀⠀⠀⠀⠀⠀⠀⠀⠀⠀⢸⣷⢀⣼⠟⠁⠀⠀⠀
⠀⠀⠀⠀⣿⡆⠀⠀⠀⠀⠀⠀⠀⠀⠀⠀⠀⣿⠇⠀⠘⣿⠀⠀⠀⠀⠀⠀⠀⠀⠀⠀⠀⠀⠀⠀⠀⠀⠀⠀⠀⠀⠀⠀⠀⠀⠀⠀⠀⠀⠀⠀⠀⠀⠀⢀⣾⠛⣿⠁⠀⠀⠀⠀⠀
⠀⠀⠀⠀⠸⣿⡀⠀⠀⠀⠀⠀⠀⠀⠀⠀⣸⡿⠀⠀⠀⠻⣧⡀⠀⠀⠀⠀⠀⠀⠀⠀⠀⠀⠀⠀⠀⠀⠀⠀⠀⠀⠀⠀⠀⠀⠀⠀⠀⠀⠀⠀⠀⠀⣠⡾⠋⠀⠘⣧⠀⠀⠀⠀⠀
⠀⠀⠀⠀⠀⠙⣷⡀⠀⠀⠀⠀⠀⠀⠀⣰⠿⠁⠀⠀⠀⠀⠉⠻⣦⣄⠀⠀⠀⠀⠀⠀⠀⠀⠀⠀⠀⠀⠀⠀⠀⠀⠀⠀⠀⠀⠀⠀⠀⠀⢀⣠⣴⠿⠋⠀⠀⠀⠀⢹⣇⠀⠀⠀⠀
⠀⠀⠀⠀⠀⠀⠈⠙⠷⣦⣤⣤⣤⠄⠀⠁⠀⠀⠀⠀⠀⠀⠀⠀⠀⠩⡛⠿⠶⣤⣤⣤⣄⣀⣀⠀⠀⠀⠀⠀⠀⣀⣀⣀⣀⣠⣤⣤⡴⠾⠛⠉⠀⠀⠀⠀⠀⠀⠀⠀⣿⡄⠀⠀⠀
⠀⠀⠀⠀⠀⠀⠀⠀⠀⢰⣿⠀⠀⠀⠀⠀⠀⠀⠀⠀⠀⠀⠀⠀⠀⠀⠀⠁⠀⠀⠀⠉⠉⠉⠉⠉⠛⠛⠛⠛⠛⠛⠛⠉⠉⠉⠀⠀⠀⠀⠀⠀⠀⠀⠀⠀⠀⠀⠀⠀⢸⣧⠀⠀⠀
⠀⠀⠀⠀⠀⠀⠀⠀⠀⣸⡏⠀⠀⠀⠀⠀⠀⠀⠀⠀⠀⠀⠀⠀⠀⠀⠀⠀⠀⠀⠀⠀⠀⠀⠀⠀⠀⠀⠀⠀⠀⠀⠀⠀⠀⠀⠀⠀⠀⠀⠀⠀⠀⠀⠀⠀⠀⠀⠀⠀⠀⣿⠀⠀⠀
⢰⡟⠙⠲⢦⣄⡀⠀⠀⢹⡇⡀⠀⠀⠀⠀⠀⠀⠀⠀⠀⠀⠀⠀⠀⠀⠀⠀⠀⠀⠀⠀⠀⠀⠀⠀⠀⠀⠀⠀⠀⠀⠀⠀⠀⠀⠀⠀⠀⠀⠀⠀⠀⠀⠀⠀⠀⠀⠀⠀⠀⣿⠀⠀⠀
⠈⢿⣄⠀⠀⠈⠙⠳⢶⣾⣷⠱⡀⠀⠀⠀⠀⠀⠀⠀⠀⠀⠀⠀⠀⠀⠀⠀⠀⠀⠀⠀⠀⠀⠀⠀⠀⠀⠀⠀⠀⠀⠀⠀⠀⠀⠀⠀⠀⠀⠀⠀⠀⠀⠀⠀⠀⠀⠀⠀⢰⡿⠀⠀⠀
⠀⠀⠛⣶⣀⠀⠀⠀⠀⠀⣿⡆⠐⠄⠀⠀⠀⠀⠀⠀⠀⠀⠀⠀⠀⠀⠀⠀⠀⠀⠀⠀⠀⠀⠀⠀⠀⠀⠀⠀⠀⠀⠀⠀⠀⠀⠀⠀⠀⠀⠀⠀⠀⠀⠀⠀⠀⠀⠀⠀⣾⡏⠀⠀⠀
⠀⠀⠀⠈⠛⣶⣄⠀⡀⠀⠘⢿⣆⠈⠢⡀⠀⠀⠀⠀⠀⠀⠀⠀⠀⠀⠀⠀⠀⠀⠀⠀⠀⠀⠀⠀⠀⠀⠀⠀⠀⠀⠀⠀⠀⠀⠀⠀⠀⠀⠀⠀⠀⠀⠀⠀⠀⠀⠀⣼⡟⠀⠀⠀⠀
⠀⠀⠀⠀⠀⠀⠙⠻⣮⣄⡂⠈⢻⣦⡀⠈⠢⢀⠀⠀⠀⠀⠀⠀⠀⠀⠀⠀⠀⠀⠀⠀⠀⠀⠀⠀⠀⠀⠀⠀⠀⠀⠀⠀⠀⠀⠀⠀⠀⠀⠀⠀⠀⠀⠀⠀⠀⢠⣾⠏⠀⠀⠀⠀⠀
⠀⠀⠀⠀⠀⠀⠀⠀⠀⠉⠻⠶⣤⣝⣿⣦⡀⠀⠁⠤⢀⠀⠀⠀⠀⠀⠀⠀⠀⠀⠀⠀⠀⠀⠀⠀⠀⠀⠀⠀⠀⠀⠀⠀⠀⠀⠀⠀⠀⠀⠀⠀⠀⠀⠀⣠⣾⠟⠁⠀⠀⠀⠀⠀⠀
⠀⠀⠀⠀⠀⠀⠀⠀⠀⠀⠀⠀⠀⠈⠉⠛⠻⢷⣤⡀⠀⠀⠀⠀⠀⠀⠀⠀⠀⠀⠀⠀⠀⠀⠀⠀⠀⠀⠀⠀⠀⠀⠀⠀⠀⠀⠀⠀⠀⠀⠀⠠⣂⣼⡾⠛⠁⠀⠀⠀⠀⠀⠀⠀⠀
⠀⠀⠀⠀⠀⠀⠀⠀⠀⠀⠀⠀⠀⠀⠀⢀⣤⠶⠋⠛⠷⣦⣄⣀⠀⠀⠀⠀⠀⠀⠀⠀⠀⠀⠀⠀⠀⠀⠀⠀⠀⠀⠀⠀⠀⠀⠀⢀⣀⣤⣶⡿⠛⠉⠛⢷⣄⠀⠀⠀⠀⠀⠀⠀⠀
⠀⠀⠀⠀⠀⠀⠀⠀⠀⠀⠀⠀⠀⣠⡾⠋⠁⠀⠀⠀⠀⠀⠉⠙⠛⠳⠶⣦⣤⣄⣀⣀⣀⣀⣀⣀⣀⣀⣀⣀⣀⣠⣤⣤⣶⡶⠿⠛⠛⠉⠀⠀⠀⠀⠀⠀⠙⢷⣄⠀⠀⠀⠀⠀⠀
⠀⠀⠀⠀⠀⠀⠀⠀⠀⠀⠀⣠⡾⠋⠀⠀⠀⠀⡄⠀⠀⠀⠀⠀⠀⢀⠀⠀⠀⠈⢿⡉⠉⠉⠉⠉⠉⠉⠉⠉⡟⠉⠀⠀⠀⠀⣀⠀⠀⠀⠀⠀⠀⠠⡆⠀⠀⠀⠙⣷⡀⠀⠀⠀⠀
⠀⠀⠀⠀⠀⠀⠀⠀⠀⠀⣼⣏⣀⣠⣤⣤⠴⠶⣷⠀⠀⠀⠀⢀⣴⢷⣤⡀⠀⠀⠈⢷⡀⠀⠀⠀⠀⠀⠀⢰⡇⠀⠀⠀⠀⣀⣼⣦⣀⠀⠀⠀⠀⣸⠛⠻⢶⣤⣀⣈⣿⠀⠀⠀⠀
⠀⠀⠀⠀⠀⠀⠀⠀⠀⠀⠁⠀⠀⠀⠀⠀⠀⠀⠘⢧⣄⣤⡾⠋⠁⠀⠈⠙⠳⠶⣤⣼⡇⠀⠀⠀⠀⠀⠀⠸⣷⣤⡴⠶⠛⠉⠀⠈⠙⠷⣦⣄⣴⠏⠀⠀⠀⠀⠈⠉⠉⠀⠀⠀⠀